id,Club,MP,W,D,L,GF,GA,GD,Pts
1,FC Basel,36,25,6,5,80,30,50,81
2,BSC Young Boys,36,24,7,5,75,35,40,79
3,FC Zürich,36,18,8,10,60,45,15,62
4,FC Luzern,36,16,10,10,55,50,5,58
5,FC Sion,36,14,12,10,50,45,5,54
6,FC St. Gallen,36,14,10,12,48,47,1,52
7,FC Lausanne-Sport,36,12,11,13,42,45,-3,47
8,FC Lugano,36,10,12,14,40,48,-8,42
9,FC Servette Genève,36,10,10,16,35,50,-15,40
10,FC Vaduz,36,8,8,20,30,65,-35,32
11,FC Thun,36,6,11,19,28,55,-27,29
12,FC Aarau,36,5,8,23,25,70,-45,23
